WWWWWWWWWWWWWWWWWWWW
W P       C        W
W WWWWWW WWWWWWTWW W
W C      W      C  W
WWWWWW W W WWWWWWWWW
W T    W C   E     W
W WWW WWWWWWWWWW W W
W K              W W
WWWWWWWWWWWWWWWW D W
WWWWWWWWWWWWWWWWWWWW